

                ██████████                
        ████████░░░░░░░░░░████████        
      ██░░░░░░░░░░░░░░░░░░░░░░░░░░██      
    ██░░░░░░░░░░░░░░░░░░░░░░░░░░░░░░██    
  ██░░░░░░░░░░░░░░░░░░            ░░██    
  ██░░░░░░░░░░░░░░                  ░░██  
██░░░░░░░░░░                        ░░░░██
██░░░░░░░░░░                        ░░░░██
██░░░░░░░░░░        ██        ██      ░░██
██░░░░░░░░          ██        ██      ░░██
██░░░░░░░░          ██        ██      ░░██
██░░░░░░░░                            ░░██
██░░░░░░░░░░                          ░░██
██░░░░░░░░░░░░                        ░░██
██░░░░░░░░░░░░░░                      ░░██
██░░░░░░░░░░░░░░░░░░                ░░░░██
████░░░░░░░░░░░░░░░░░░░░░░░░░░░░░░░░░░████
    ██████████████████████████████████    


